Oracle Red Bull Racing
Oracle | Cloud Applications and Cloud Platform
Hard Rock International | Hard Rock
TAG Heuer® Official Website - Swiss Luxury Watches since 1860
Telcel es la Red
Mobil
Content Drops | Bybit x Oracle Red Bull Racing | Bybit
RBR and SAT | Honda.Racing
Claro
Rauch Fruchtsäfte
Yhteistyöratkaisut – videoneuvottelut, neuvottelupuhelimet ja kuulokkeet | Poly, formerly Plantronics & Polycom
Armor All - Everyday proof your car | Armor All US
Cash App - Do more with your money
Oracle Red Bull Racing - Sign Up – Castore
New Era Cap | Headwear, Clothing & Accessories | New Era Cap Finland
Arctic Wolf | The Leader in Security Operations
One platform to connect | Zoom
Hewlett Packard Enterprise (HPE)
inter.mx
Unlimited Data Plans, Internet & TV | AT&T
Oracle Red Bull Racing | Customer Success
Online Poker – Play Poker Games at PokerStars
Blenders Eyewear - Sunglasses, Snowboard & Ski Goggles & Prescription
Theragun Therabody | World-Leading Wellness Solutions - Therabody
Pirelli Global Website: discover our World
AlphaTauri | Official Online Store
DMG MORI UK - CNC machine tools for all cutting-machining applications
Manufacturing Intelligence | Hexagon
PWR Advanced Cooling Technology | PWR Corporate
Ansys | Engineering Simulation Software
The Gold Standard
Sabelt – Racing World, Original Equipment Manufacturing, special Application seatbelts - Car Seats, Belts and Motorsport Products, Sabelt is dedicated to the development and the improvementation of 3 business units: Racing, OEM (seats for original equipment) and special application seatbelts.
The world's most needed reusable bottle | Ocean Bottle
Homepage | BMC
Walmart Inc.